26,26
0,0,0,0,0,0,0,0,0,0,0,0,0,0,0,0,0,0,0,0,0,0,0,0,0,2
0,0,0,0,0,0,0,0,0,0,0,0,0,0,0,0,0,0,0,0,0,0,0,0,0,2
0,0,0,0,0,0,0,0,0,0,0,0,0,0,0,0,0,0,0,4,0,0,0,0,0,2
0,0,0,0,0,0,0,0,0,0,0,0,0,3,3,0,0,0,0,0,0,0,0,0,0,2
0,0,0,0,0,0,0,0,0,0,0,0,3,0,0,3,0,0,0,0,0,0,0,0,0,2
0,0,0,0,0,0,0,0,0,0,3,3,0,0,0,0,3,3,3,0,0,0,0,0,0,2
1,1,1,1,1,1,1,1,1,1,1,1,1,0,0,1,1,1,1,1,1,1,1,3,0,2
2,2,2,2,2,2,2,2,2,2,2,2,2,0,0,2,2,2,2,2,2,2,2,0,3,2
2,2,2,2,2,2,2,2,2,2,0,0,0,0,4,0,0,0,0,2,2,2,2,3,0,2
2,2,2,2,2,2,2,2,2,2,0,0,0,0,0,0,0,0,3,2,2,2,2,0,3,2
2,2,2,2,2,2,2,2,2,2,0,0,0,4,0,0,0,3,3,2,2,2,2,3,0,2
2,2,2,2,2,2,2,2,2,2,0,4,0,0,0,0,3,3,3,2,2,2,2,0,3,2
2,2,2,2,2,2,2,2,2,2,0,0,0,0,0,3,3,3,3,2,2,2,2,3,0,2
2,2,2,2,2,2,2,2,2,2,0,3,3,3,3,3,3,3,3,2,2,2,2,0,3,2
2,2,2,2,2,2,2,2,2,2,2,2,2,2,2,2,2,2,2,2,2,2,2,3,0,2
2,0,0,0,0,0,0,0,0,0,0,0,0,0,0,0,0,0,0,0,0,0,0,0,3,2
2,0,0,0,0,0,0,0,0,0,0,0,0,0,0,0,0,0,0,0,0,0,0,3,0,2
2,0,0,0,0,0,0,0,0,0,0,0,0,0,0,0,0,0,0,0,0,0,0,0,3,2
2,0,0,0,0,0,0,0,0,0,0,0,0,0,0,0,0,0,0,0,0,0,0,3,0,2
2,0,0,0,0,0,0,0,0,0,0,0,0,0,0,0,0,0,0,0,0,0,0,0,3,2
2,0,0,0,0,0,4,0,0,4,0,0,0,0,0,0,0,0,0,0,0,0,0,3,0,2
2,0,0,0,0,0,0,0,0,0,0,0,0,0,0,0,3,3,0,0,0,0,0,0,3,2
2,0,8,0,0,0,0,0,0,0,0,0,0,0,0,3,0,0,3,0,0,0,0,3,0,2
2,0,9,0,0,0,0,0,0,0,0,0,0,3,3,0,0,0,0,3,3,0,0,0,3,2
2,1,1,1,1,1,1,1,1,1,1,1,1,1,1,1,0,0,1,1,1,1,1,1,1,2
2,2,2,2,2,2,2,2,2,2,2,2,2,2,2,2,0,0,2,2,2,2,2,2,2,2